NO ./assets/textures/north.xpm
SO ./assets/textures/south.xpm
WE ./assets/textures/west.xpm
EA ./assets/textures/east.xpm
F 220,100,0
C 225,30,0

111111111111111111111
1S1010000010100000001
101010111110111011111
100000001010101000001
101111101010101111101
100010101000001010101
101010101011111010101
101010001010000000001
101111101011111011101
101000000000000000101
111011111110101111101
100010101000100010101
101010101011111110101
101000100000101000001
111110101010101111101
100000101010100010001
111010111111101111101
101010001010000000001
101110111010101110101
100000000010100010101
111111111111111111111
